0 4 2
22222222222222222222
20000000000000000002
22200001111111111002
22200001000000001002
11110001001111111002
22210001001000000222
22210001001111111222
20010001000000001213
20010001001111111212
20010001001000000212
20011111001111111112
20000000000000000002
20000000000000000002
20000000000000000002
22222222222222222222
