0 7 2
22222222222222222222
00000000000000000002
00011111111111111002
00010000000000001002
00010000000000001002
00010011111111001000
00010010000001001000
11110012222201001000
22220012222201001000
22220010031111001000
00000010000000001000
00000010000000001000
00000011111111111000
00000000000000000000
00000000000000000000
